0,0,0,0,0,0,0,0,0,0,0,0,0,0,0
0,0,0,0,0,0,0,0,0,0,0,0,0,0,0
0,0,0,0,0,0,0,0,0,0,0,0,0,0,0
0,0,0,0,3,3,0,0,3,3,0,0,0,0,0
0,0,0,3,3,3,3,3,3,3,3,0,0,0,0
0,0,0,3,3,3,3,3,3,3,3,0,0,0,0
0,0,0,0,3,3,3,3,3,3,0,0,0,0,0
0,0,0,0,0,3,3,3,3,0,0,0,0,0,0
0,0,0,0,0,0,3,3,0,0,0,0,0,0,0
0,0,0,0,0,0,0,0,0,0,0,0,0,0,0
0,0,0,0,0,0,0,0,0,0,0,0,0,0,0
0,0,0,0,0,0,0,0,0,0,0,0,0,0,0
0,0,0,0,0,0,0,0,0,0,0,0,0,0,0
0,0,0,0,0,0,0,0,0,0,0,0,0,0,0
0,0,0,0,0,0,0,0,0,0,0,0,0,0,0
--
0,0,0,0,0,0,0,0,0,0,0,0,0,0,0
0,0,0,0,0,0,0,0,0,0,0,0,0,0,0
0,0,0,0,0,0,0,0,0,0,0,0,0,0,0
0,0,0,0,0,0,4,4,4,4,0,0,0,0,0
0,0,0,0,0,4,4,4,4,4,4,0,0,0,0
0,0,0,0,4,4,0,4,4,0,4,4,0,0,0
0,0,0,0,4,4,4,4,4,4,4,4,0,0,0
0,0,0,0,4,0,4,4,4,4,0,4,0,0,0
0,0,0,0,0,0,4,0,0,4,0,0,0,0,0
0,0,0,0,0,4,0,0,0,0,4,0,0,0,0
0,0,0,0,0,0,0,0,0,0,0,0,0,0,0
0,0,0,0,0,0,0,0,0,0,0,0,0,0,0
0,0,0,0,0,0,0,0,0,0,0,0,0,0,0
0,0,0,0,0,0,0,0,0,0,0,0,0,0,0
0,0,0,0,0,0,0,0,0,0,0,0,0,0,0
--
0,0,0,0,0,0,0,0,0,0,0,0,0,0,0
0,0,0,0,0,0,0,0,0,0,0,0,0,0,0
0,0,0,0,0,0,0,0,0,0,0,0,0,0,0
0,0,0,0,0,0,0,0,0,0,0,0,0,0,0
0,0,0,0,0,0,0,0,0,0,0,0,0,0,0
0,0,0,0,0,0,0,0,0,0,0,0,0,0,0
0,0,0,0,0,0,0,0,0,0,0,0,0,0,0
0,0,0,0,0,0,0,0,0,0,0,0,0,0,0
0,0,0,0,0,0,0,0,0,0,0,0,0,0,0
0,0,0,0,0,0,0,0,0,0,0,0,0,0,0
0,0,0,0,1,0,0,0,0,0,1,0,0,0,0
0,0,0,1,1,1,0,0,0,1,1,1,0,0,0
0,0,1,1,1,1,1,0,1,1,1,1,1,0,0
0,0,0,0,0,1,1,0,0,1,1,0,0,0,0
0,0,0,0,1,1,1,0,1,1,1,0,0,0,0
--
0,0,0,0,0,0,0,0,0,0,0,0,0,0,0
0,0,0,0,0,0,0,0,0,0,0,0,0,0,0
0,0,0,0,0,0,0,0,0,0,0,0,0,0,0
0,0,0,0,0,0,0,0,0,0,0,0,0,0,0
0,0,0,0,0,0,0,0,0,0,0,0,0,0,0
0,0,0,0,0,0,0,0,0,0,0,0,0,0,0
0,0,0,0,0,0,0,0,0,0,0,0,0,0,0
0,0,0,1,1,0,1,1,1,0,1,1,0,0,0
0,0,1,1,1,1,1,1,1,1,1,1,1,0,0
0,0,1,1,1,1,1,1,1,1,1,1,1,0,0
0,0,0,1,1,1,1,1,1,1,1,1,0,0,0
0,0,0,1,1,1,1,1,1,1,1,1,0,0,0
0,0,0,1,1,1,1,0,1,1,1,1,0,0,0
0,0,0,1,1,1,1,1,1,1,1,1,0,0,0
0,0,0,1,1,1,1,1,1,1,1,1,0,0,0
--
0,0,0,0,0,0,1,0,1,0,0,0,0,0,0
0,0,0,0,0,0,1,1,1,1,0,0,0,0,0
0,0,0,0,0,0,1,1,1,1,1,0,0,0,0
0,0,0,1,1,0,1,1,1,0,1,1,0,0,0
0,0,1,1,1,1,1,1,1,1,1,1,1,0,0
0,0,1,1,1,1,1,1,1,1,1,1,1,0,0
0,0,0,1,1,1,1,1,1,1,1,1,0,0,0
0,0,0,0,1,1,1,1,1,1,1,0,0,0,0
0,0,0,0,0,1,1,0,1,1,0,0,0,0,0
0,0,0,0,0,0,0,1,0,0,0,0,0,0,0
0,0,0,0,0,1,1,1,1,1,0,0,0,0,0
0,0,0,0,0,0,1,1,1,0,0,0,0,0,0
0,0,0,0,0,1,1,1,1,1,0,0,0,0,0
0,0,0,0,0,0,0,1,0,0,0,0,0,0,0
0,0,0,0,0,0,0,0,0,0,0,0,0,0,0
--
0,0,0,0,0,0,0,0,0,0,0,0,0,0,0
0,2,2,2,0,0,0,0,0,0,0,2,2,2,0
0,2,2,2,0,0,0,0,0,0,0,2,2,2,0
0,2,2,2,0,0,0,0,0,0,0,2,2,2,0
0,2,2,0,0,0,0,0,0,0,0,0,0,2,2
0,2,2,2,0,2,1,0,0,0,1,2,0,2,2
0,0,0,0,2,2,1,0,0,1,2,2,0,0,0
0,0,0,2,2,2,1,0,1,2,2,2,0,0,0
0,0,0,0,0,0,0,0,0,0,0,0,0,0,0
0,0,0,0,0,0,0,0,0,0,0,0,0,0,0
0,0,0,0,0,1,1,1,1,1,0,0,0,0,0
0,0,0,0,0,1,1,1,1,1,0,0,0,0,0
0,0,0,0,0,1,1,1,1,1,0,0,0,0,0
0,0,0,0,0,0,0,0,0,0,0,0,0,0,0
0,0,0,0,0,0,0,0,0,0,0,0,0,0,0
--
0,0,0,0,0,0,0,0,0,0,0,0,0,0,0
0,0,0,0,0,0,0,0,0,0,0,0,0,0,0
0,0,0,2,0,0,0,0,0,0,0,2,0,0,0
0,0,2,2,2,0,0,0,0,0,2,2,2,0,0
0,2,2,2,2,2,0,0,0,2,2,2,2,2,0
0,0,0,0,0,0,0,0,0,0,0,0,0,0,0
0,0,0,0,0,0,0,0,0,0,0,0,0,0,0
0,0,0,0,1,1,0,0,0,1,1,0,0,0,0
0,0,0,0,1,1,0,0,0,1,1,0,0,0,0
0,0,0,1,1,1,0,0,0,1,1,1,0,0,0
0,1,1,1,1,1,0,0,0,1,1,1,1,1,0
0,0,0,1,1,1,0,0,0,1,1,1,0,0,0
0,0,1,0,1,1,1,0,1,1,1,0,0,0,1
0,1,1,1,1,1,1,1,1,1,1,1,0,1,1
1,1,1,0,0,0,0,0,0,0,0,0,1,1,1
--
0,0,0,0,0,0,0,0,0,0,0,0,0,0,0
0,0,0,0,0,0,0,0,0,0,0,0,0,0,0
0,0,0,0,0,0,0,2,0,0,0,0,0,0,0
0,0,0,0,0,2,2,2,2,2,0,0,0,0,0
0,0,0,0,0,0,2,2,2,0,0,0,0,0,0
0,0,0,0,0,2,2,2,2,2,0,0,0,0,0
0,0,0,0,0,0,0,2,0,0,0,0,0,0,0
0,0,0,1,0,0,0,0,0,0,0,1,0,0,0
0,0,1,1,1,0,0,0,0,0,1,1,1,0,0
0,1,1,1,1,1,1,0,1,1,1,1,1,1,0
0,0,0,1,1,1,1,1,1,1,1,1,0,0,0
0,0,0,1,1,1,1,1,1,1,1,1,0,0,0
0,0,1,1,1,1,1,1,1,1,1,1,1,0,0
0,0,1,1,1,1,1,1,1,1,1,1,1,0,0
0,0,1,1,1,1,1,1,1,1,1,1,1,0,0
--
0,0,0,0,0,0,0,0,0,0,0,0,0,0,0
0,0,0,2,0,0,0,0,0,0,0,2,0,0,0
0,2,2,2,2,2,0,0,0,2,2,2,2,2,0
1,1,2,2,2,0,2,0,2,0,2,2,2,1,1
1,2,2,2,2,2,2,2,2,2,2,2,2,2,1
1,1,1,2,1,1,2,2,2,2,2,2,1,1,1
0,0,0,1,1,1,1,1,1,1,1,1,0,0,0
0,0,0,1,1,1,1,1,1,1,1,1,0,0,0
0,0,0,1,1,1,1,1,1,1,1,1,0,0,0
0,0,0,1,1,1,1,0,1,1,0,1,1,0,0
0,0,0,1,1,1,0,0,0,1,1,1,1,1,0
0,0,0,0,0,0,0,0,0,0,0,0,0,0,0
0,0,0,0,0,0,0,0,0,0,0,0,0,0,0
0,0,0,0,0,0,0,0,0,0,0,0,0,0,0
0,0,0,0,0,0,0,0,0,0,0,0,0,0,0
--
0,1,0,0,0,0,1,2,1,0,0,0,0,1,0
0,1,1,0,1,1,1,1,1,1,1,0,0,1,1
0,1,1,1,1,1,1,1,1,1,1,1,0,1,1
0,0,1,1,1,1,1,1,1,1,1,1,1,0,0
0,0,0,1,1,1,1,1,1,1,1,1,0,0,0
0,0,1,1,1,2,0,0,0,2,1,1,1,0,0
0,1,1,1,1,2,2,0,0,2,2,1,1,1,0
0,0,1,1,1,2,2,2,0,2,2,2,1,0,0
0,0,1,1,1,1,1,0,1,1,1,1,1,0,0
0,0,1,1,1,1,1,0,1,1,1,1,1,0,0
0,0,1,1,1,1,1,0,1,1,1,1,1,0,0
0,0,0,0,0,0,0,0,0,0,0,0,0,0,0
0,0,0,0,0,0,0,0,0,0,0,0,0,0,0
0,0,0,0,0,0,0,0,0,0,0,0,0,0,0
0,0,0,0,0,0,0,0,0,0,0,0,0,0,0
--
0,0,0,0,0,0,0,0,0,0,0,0,0,0,0
0,0,0,0,0,0,0,0,0,0,0,0,0,0,0
0,0,0,0,0,0,0,3,0,3,0,0,0,0,0
0,0,0,0,2,2,2,2,2,2,2,0,0,0,0
0,0,2,0,2,2,2,2,2,2,2,0,2,0,0
0,2,2,2,2,2,2,2,2,2,2,2,2,2,0
2,2,2,2,2,0,0,0,0,0,2,2,2,2,2
1,1,1,1,1,0,0,0,0,0,1,1,1,1,1
1,1,1,1,1,1,0,0,0,1,1,1,1,1,1
0,1,1,1,1,1,1,0,1,1,1,1,1,1,0
1,1,0,1,1,0,1,1,1,0,1,1,0,1,1
1,1,1,1,1,1,1,1,1,1,1,1,1,1,1
1,0,1,1,1,1,0,1,0,1,1,1,1,0,1
0,0,1,0,0,1,0,0,0,1,0,0,1,0,0
0,1,0,0,0,0,1,0,1,0,0,0,0,1,0
--
0,0,0,0,3,3,3,0,3,3,3,0,0,0,0
0,0,0,3,3,3,3,3,3,3,3,3,0,0,0
0,0,0,3,3,3,3,3,3,3,3,3,0,0,0
0,0,3,3,3,3,3,3,3,3,3,2,3,0,0
0,3,1,2,2,3,3,3,3,3,2,2,1,3,0
0,1,1,1,1,1,3,3,3,1,1,1,1,1,0
1,1,1,1,1,1,1,1,1,1,1,1,1,1,1
0,0,0,0,1,1,1,1,1,1,1,0,0,0,0
0,0,0,0,1,1,1,1,1,1,1,0,0,0,0
0,0,0,1,1,1,1,1,1,1,1,1,0,0,0
0,0,1,1,0,1,1,0,1,1,0,1,1,0,0
0,0,1,1,1,1,1,1,1,1,1,1,1,0,0
0,0,1,0,1,1,1,2,1,1,1,0,1,0,0
0,0,0,0,1,0,0,2,2,0,1,0,0,0,0
0,0,0,1,0,0,1,2,2,2,0,1,0,0,0
--
0,0,1,1,1,1,1,0,1,1,1,1,1,0,0
0,0,1,1,1,1,1,0,1,1,1,1,1,0,0
0,1,1,1,1,1,1,1,1,1,1,1,1,1,0
1,1,1,1,2,2,1,1,1,2,2,1,1,1,1
0,0,0,2,2,2,2,2,2,2,2,2,0,0,0
0,0,0,2,2,2,2,2,2,2,2,2,0,0,0
0,0,0,2,2,2,2,2,2,2,2,2,0,0,0
0,0,4,2,2,2,2,2,2,2,2,2,4,0,0
4,4,4,4,4,2,2,2,2,2,4,4,4,4,4
0,2,4,3,2,2,2,3,2,2,2,3,4,2,0
0,3,3,3,3,1,2,3,2,1,3,3,3,3,0
0,0,0,3,1,1,1,3,1,1,1,3,0,0,0
0,0,2,1,1,1,1,1,1,1,1,1,2,0,0
0,0,0,0,0,0,0,0,0,0,0,0,0,0,0
0,0,0,0,0,0,0,0,0,0,0,0,0,0,0
--
0,0,5,5,5,5,0,4,0,5,5,5,5,0,0
0,5,5,5,5,5,5,4,5,5,5,5,5,5,0
5,5,0,5,5,6,5,5,5,4,5,5,0,5,5
5,5,5,5,5,5,5,5,5,5,5,5,5,5,5
5,0,5,5,5,5,6,5,6,5,5,5,5,0,5
0,5,5,6,6,5,6,6,6,5,6,6,5,5,0
5,5,4,4,6,6,5,5,5,6,6,4,4,5,5
5,5,5,5,5,6,5,5,5,6,5,5,5,5,5
5,5,4,4,5,5,5,5,5,5,5,4,4,5,5
5,5,4,4,4,5,5,4,5,5,4,4,4,5,5
5,5,4,5,5,5,5,5,5,5,5,5,4,5,5
0,0,4,4,4,5,4,4,4,5,4,4,4,0,0
0,0,0,4,4,4,4,0,4,4,4,4,0,0,0
0,0,0,0,4,4,0,0,0,4,4,0,0,0,0
0,0,0,0,0,0,0,0,0,0,0,0,0,0,0
--
0,0,0,0,4,4,4,4,4,4,4,0,0,0,0
0,0,0,0,4,4,4,4,4,4,4,0,0,0,0
0,0,4,4,4,4,5,0,5,4,4,4,4,0,0
0,0,4,4,5,4,4,4,4,4,5,4,4,0,0
0,0,4,4,4,4,4,4,4,4,4,4,4,0,0
0,0,0,4,4,4,4,4,4,4,4,4,0,0,0
5,5,5,4,4,4,4,4,4,4,4,4,5,5,5
4,5,5,4,4,4,4,4,4,4,4,4,5,5,4
4,4,5,5,5,4,4,6,4,4,5,5,5,6,4
4,4,4,4,4,4,4,4,4,4,4,4,6,6,4
6,6,4,4,4,4,4,4,4,4,4,4,4,6,6
4,4,4,4,4,4,4,4,4,4,4,4,4,4,4
4,4,0,4,4,4,4,4,4,4,4,4,0,0,4
4,4,4,4,4,4,4,4,4,4,4,4,0,0,4
0,0,0,0,0,4,4,0,4,4,0,0,0,0,0
--